NO ./textures/north.xpm

SO ./textures/south.xpm
WE ./textures/west.xpm
EA ./textures/east.xpm

F 220,100,0
C 225,30,0

11  11 111111 
10111100
101N011
11000011
1111111
